1111111111111111111111111
10010000E00C0000000000001
1000011111000000000000001
1110100000000000000000001
1P0C110000000000000000001
1000000000000011110000001
1000000000000000000000001
1000000011000000001000001
1000000000000000001000001
1000000000000000000000001
1111111111111111111111111