1111111111111111111111111
10010000E00C0000000100001
1000011111000000000100001
11101000000C0000000100001
1P0C110000000001000000001
1000000000000011110000001
10C0000000111100011000001
1000000011000000001000001
1000000000000000001000001
1000000111111110000000001
1111111111111111111111111