1111111111111
10010000100C1
1C00011111111
100011E000001
1000011111101
100C110000001
1P00000000001
1111111111111