1111111111111
10010000000C1
1C00011111001
1000111000001
1000011111101
100C110000001
1P00000000001
1111111111111