1111111111111
1001000000001
1000011111001
100011E000001
1000011111101
1000110000001
1P00000000001
1111111111111