1111111111111
10010000E00C1
1000011111001
1111111111111
1P00110000001
1111111111111